#####
#@  #
# #$###
# $ ..#
#######